1111111111111111
1010000100000001
1000000000000001
1000000000000000
1100000000000001
1000000000000001
1000000000000001
1000022222000001
1000022222000001
1000022222000001
1000022222000001
1111111111111111